11111111111
1E000010001
111001C0001
100101G0001
1C001000001
1P00000G001
11111111111
