1111111111111111
10P0000001000001
1000000001000001
1000000000000001
100E000001000001
1000000001000001
1000000C00000001
1111111111111111
