111111111111
1000000C0001
100000000001
10000000G001
1E000P000001
1000C0000001
111011111111
