111111111111
1000E000G001
100000P00101
100C000010001
111111111111
