11111111
1E0C0P01
10000X01
100G0001
11111111
