1111111111111111
1P000100001C0001
10001G0000010001
1001000001000001
100C00010001G001
100100001G001111
1010000C100000E1
1111111111111111
